JA	Y AA
JAF	JH AE F
JAK	JH AE K
JAL	JH AE L
JAN	JH AE N
JAR	JH AA R
JARH	JH AA R
JARL	JH AA R L
JARM	JH AA R M
JART	JH AA R T
JARV	JH AA R V
JARVA	JH AA R V AH
JARVE	JH AA R V
JARVIC	JH AA R V AH K
JARVICA	JH AA R V AH K AH
JARVICE	JH AA R V AY S
JARVICI	JH AA R V AH S IY
JARVIH	JH AA R V IY
JARVIN	JH AA R V AH N
JARVIT	JH AA R V AH T
JARVY	JH AA R V IY
JAT	JH AE T
